***********
*P        *
*         *
*         *
*         *
*         *
*         *
*         *
*        G*
***********