***********
*P        *
**        *
*   ***   *
*         *
*         *
***       *
*M*       *
*       *G*
***********